NO src/textures/n_wall.xpm42
SO src/textures/s_wall.xpm42
WE src/textures/w_wall.xpm42
EA src/textures/e_wall.xpm42
DO src/textures/door.xpm42

C 235,202,255
F 120,146,88
  
  111111111111111111111111111111
  100000000002000000000000000011
  111100000111000000011111111111
  111111111100000000000000011111
  111100000111000000000011111111
  111111111001100000111211110011
  111101111111110111000000100011
  111101111111110111010100100011
  110000001101010111000000100011
  1000000000000000110000001121111
  100000000000000011000100000011
  110000001101010000000000000011
  111101111101010000000000000011
  100000000011111111211111112111
  100000000000000000000000010011
  100000001111110010000N00001011
  100000001   10011011111000011
  10000000111111000001 101000011
  11111111111111111111 111111111