NO src/textures/n_wall.xpm42
SO src/textures/s_wall.xpm42
WE src/textures/w_wall.xpm42
EA src/textures/e_wall.xpm42
DO src/textures/door.xpm42

C 235,202,255
F 120,146,88

111111
110101
100001
1100N1
111111