NO src/textures/n_wall.xpm42
SO src/textures/s_wall.xpm42
WE src/textures/w_wall.xpm42
EA src/textures/e_wall.xpm42
DO src/textures/door.xpm42

C 235,202,195
F 120,146,88

S 25.5 2.5 2 src/textures/blue_junimo.xpm42
S 24.3 2.8 2 src/textures/pink_junimo.xpm42
S 21.5 2.4 2 src/textures/green_junimo.xpm42
S 20.5 4.1 2 src/textures/yellow_junimo.xpm42
S 25.5 3.14 2 src/textures/pink_junimo.xpm42
S 6.5 14.14 2 src/textures/pink_junimo.xpm42
S 7.5 14.14 2 src/textures/green_junimo.xpm42
S 8.5 15.14 2 src/textures/blue_junimo.xpm42
S 10.5 15.14 2 src/textures/yellow_junimo.xpm42
S 4.5 10.5 2 src/textures/yellow_junimo.xpm42
S 21.3 1.8 2 src/textures/blue_junimo.xpm42

11111111111111111111111111111111
   10000000000000000000100000001
   10000000000011110000200000001
   1000000N00001  10000100000001
11110000000000011110100000001111
10000000000000000000200000001
10000000000000000000100000001
10000000000000000000100000001
11111111111111121111111111111
10000000000100000000000000001
10000000000100000000000000001
10000000000100000000000000001
10000000000200011111111100001
1000000000010001       100001
1000000000010001       100001
1000000000020001       100001
1000000000010001       100001
1111111111111111       111111